81. .7. .5.
276 ..3 ..4
... ..6 ..9

... .3. ...
3.. 4.1 ..7
... .9. ...

7.. 3.. ...
5.. 1.. 392
.3. .2. .16
