2.. .19 5..
7.. .3. 1.8
.8. ... ...

..8 ..3 .2.
... ... ...
.1. 4.. 8..

... ... .6.
3.6 .4. ..7
..5 27. ..1
